{
  "customPattern": [
    0,0,0,0,0,0,0,0,0,0,
    0,0,0,0,0,0,0,0,0,0,
    0,0,0,0,0,1,1,1,0,0,
    0,0,0,0,1,1,1,1,0,0,
    0,0,1,1,1,1,1,1,0,0,
    0,0,1,1,1,1,1,1,0,0,
    0,0,1,1,1,1,1,0,0,0,
    0,0,0,1,1,1,1,0,0,0,
    0,0,0,0,0,0,0,0,0,0,
    0,0,0,0,0,0,0,0,0,0
  ],
  "patternRows": 10,
  "patternCols": 10,
  "landmarkRadius": 1.5,
  "overlapPadding": 2.0
}